3 7 6 0 3 4 5 8 2 1 1 4 5 6 8 7 3 0 2
3 8 7 3 5 4 6 0 2 1 5 7 4 0 1 6 8 2 3
3 5 3 0 2 8 1 4 6 7 0 5 1 3 6 2 4 7 8
3 0 8 5 7 4 2 3 6 1 7 6 1 8 2 0 3 4 5
3 7 6 1 8 2 0 3 4 5 6 0 5 7 3 2 8 1 4
3 5 4 8 0 2 6 3 1 7 0 3 4 8 6 1 7 5 2
3 5 3 0 6 7 1 2 4 8 8 2 7 6 4 0 5 3 1
3 2 7 3 8 1 6 5 0 4 1 2 6 5 7 0 8 3 4
3 4 5 8 2 0 3 1 7 6 6 8 5 7 1 4 2 3 0
3 1 3 7 2 0 4 8 6 5 2 5 4 1 3 7 6 0 8