3 5 0 8 4 2 1 7 3 6 1 2 3 4 5 6 7 8 0
3 6 4 7 8 5 0 3 2 1 1 2 3 4 5 6 7 8 0
3 8 6 7 2 5 4 3 0 1 1 2 3 4 5 6 7 8 0
4 8 13 0 6 1 15 9 14 3 4 5 11 7 2 10 12 1 2 3 4 5 6 7 8 9 10 11 12 13 14 15 0
4 2 9 5 11 8 3 4 14 7 10 1 12 0 15 6 13 1 2 3 4 5 6 7 8 9 10 11 12 13 14 15 0
4 4 7 0 9 12 10 11 8 14 6 15 1 2 5 3 13 1 2 3 4 5 6 7 8 9 10 11 12 13 14 15 0
4 12 10 3 2 0 7 14 9 1 15 5 6 8 4 13 11 1 2 3 4 5 6 7 8 9 10 11 12 13 14 15 0
4 12 1 5 6 2 11 7 9 14 10 0 4 15 3 13 8 1 2 3 4 5 6 7 8 9 10 11 12 13 14 15 0
4 4 6 15 13 12 9 10 2 8 0 7 3 14 5 1 11 1 2 3 4 5 6 7 8 9 10 11 12 13 14 15 0